20
..ooo.......o.......
..oo.......o........
oooo.o..............
......oo............
....................
o..o................
....................
........o...........
..................o.
.....o..............
................o...
.......o.........o..
.............oo.....
....................
....................
.o..................
....................
..................o.
....o...............
.............o......
